24, 20,
456, 457, 456, 457, 456, 457, 456, 457, 456, 457, 456, 457, 45,  46, 456, 457, 456, 457, 456, 457, 456, 457, 456, 457,
460, 461, 458, 459, 458, 459, 458, 459, 458, 459, 458, 459, 39,  40, 458, 459, 458, 459, 458, 459, 458, 459, 460, 461,
456, 457,  45,  41,  41,  41,  41,  41,  41,  41,  41,  41, 50,  49,  41,  41,  41,  41,  41,  41,  46, 151, 456, 457,
460, 461,  39,  38,  38,  38,  38,  38,  38,  38,  38,  38, 39,  40,  38,  38,  38,  38,  38,  38,  40, 151, 460, 461,
456, 457,  39,  38,  38,  38,  38,  38,  38,  38,  38,  38, 39,  40,  38,  38,  38,  38,  38,  38,  40, 151, 456, 457,
460, 461,  39,  38,  38,  38,  38,  38,  38,  38,  38,  38, 39,  40,  38,  38,  38,  38,  38,  38,  40, 151, 460, 461,
456, 457,  39,  38,  38,  38,  38,  38,  38,  38,  38,  38, 39,  40,  38,  38,  38,  38,  38,  38,  40, 151, 456, 457,
460, 461,  39,  38,  38,  38,  38,  38,  38,  38,  38,  38, 39,  40,  38,  38,  38,  38,  38,  38,  40, 151, 460, 461,
456, 457,  39,  38,  38,  38,  38,  38,  38,  38,  38,  38, 39,  40,  38,  38,  38,  38,  38,  38,  40, 151, 456, 457,
460, 461,  39,  38,  38,  38,  38,  38,  38,  38,  38,  38, 39,  40,  38,  38,  38,  38,  38,  38,  40, 151, 460, 461,
456, 457,  39,  38,  38,  38,  38,  38,  38,  38,  38,  38, 39,  40,  38,  38,  38,  38,  38,  38,  40, 151, 456, 457,
460, 461,  39,  38,  38,  38,  38,  38,  38,  38,  38,  38, 39,  40,  38,  38,  38,  38,  38,  38,  40, 151, 460, 461,
456, 457,  39,  38,  38,  38,  38,  38,  38,  38,  38,  38, 39,  40,  38,  38,  38,  38,  38,  38,  40, 151, 456, 457,
460, 461,  39,  38,  38,  38,  38,  38,  38,  38,  38,  38, 39,  40,  38,  38,  38,  38,  38,  38,  40, 151, 460, 461,
456, 457,  39,  38,  38,  38,  38,  38,  38,  38,  38,  38, 39,  40,  38,  38,  38,  38,  38,  38,  40, 151, 456, 457,
460, 461,  39,  38,  38,  38,  38,  38,  38,  38,  44,  38, 45,  41,  41,  41,  41,  41,  41,  46,  40, 151, 460, 461,
456, 457,  39,  38,  38,  38,  38,  38,  38,  38,  38,  38, 43, 251, 251, 251, 251, 251, 251,  44,  40, 151, 456, 457,
460, 461,  43,  42,  42,  42,  42, 310, 311, 311, 312,  38, 38,  38,  38,  38,  38,  38,  38,  38,  40, 151, 460, 461,
456, 457, 151, 151, 151, 151, 151, 313, 314, 314, 315,  42, 42,  42,  42,  42,  42,  42,  42,  42,  44, 151, 456, 457,
460, 461, 450, 451, 450, 451, 151, 313, 314, 314, 315, 151,151, 151, 151, 151, 151, 151, 450, 451, 450, 451, 460, 461,